SO ./wolftex/22.xpm
EA ./wolftex/21.xpm
NO ./wolftex/25.xpm
WE ./wolftex/24.xpm
S ./wolftex/kratos3.xpm
R  1920 1080
F 111,11,11
C 1,111,111
11111111111111111
10000000000000001
10202020N02020201
10002000200200001
10000000000000001
11111111111111111
